011111000011100
000100000010000
011111111111110
000010000000100
011111111000100
000001000000100
011111111100100
000001010000100
000001010111100
000001010011110
011101011100100
010101000110110
020101011100030
000111011000040
000000001000000