000100111100000
011110111110031
010110000010010
111111111010010
010100001011111
011111101010000
010110101011110
011110101000100
010110101111110
111110000000000
110000011101120
011111110101000
010110010111111
011110110110110
000010000110000