000000000001111
011111111101011
111010100101011
011111100101001
011010100101101
011111101100101
001000001011101
001111001010001
000001011011101
031111010000101
040000010000101
001111011111101
021001000000011
000001111111111
000000000000000