000000000000000
040111000111010
030101000101010
011111111111110
010000101000010
000010101010000
000011121110000
000110101011000
000000101000000
011111111111110
000000010000000
011111111111110
010101010101010
010010101010010
011111111111110