000000000000000
111111111110111
100000010010111
101111010010111
101001010010010
101001011010010
101001000011110
111101110000100
010000010000100
010111010000100
010111011111110
010111000001110
020301111101000
000401110111110
000000000000000